rows 10
cols 10
start 0,0
goal 0,9
..........
@@@@@@....
....@.....
@@..@.@@@@
....@.....
....@.....
..@.@@@@..
..@.......
..@...@...
..@...@...
